25 16
4
80 80

Assets\Tiles\FloorTile.txt
Assets\Tiles\WallTile.txt
Assets\Tiles\GrassTile.txt
Assets\Tiles\FurnitureTile.txt

2 2 2 2 2 2   2 2 2 2 2   2 2 2 2 2   2 2 2 2 2  2 2 2 2
2 1 1 1 1 1   1 1 1 1 1   1 2 2 2 0   0 2 2 2 2  2 2 2 2
2 1 0 0 0 0   1 3 0 0 3   1 1 1 1 1   1 1 1 1 1  1 1 1 2
2 1 0 0 3 3   1 3 0 0 3   1 0 0 1 0   0 1 0 0 0  0 0 1 2
2 1 0 0 0 0   1 0 0 0 0   1 0 0 1 0   0 0 0 3 3  3 0 1 2
2 1 1 1 1 0   1 0 1 1 1   1 1 0 1 0   0 0 0 3 3  3 0 1 2

2 1 0 0 0 0   0 0 0 0 0   0 0 0 0 0   0 1 0 0 0  0 0 1 2
2 1 0 0 0 0   0 0 0 0 0   0 0 0 0 0   0 1 1 0 0  1 1 1 2
2 1 1 1 0 1   1 1 1 1 1   1 1 1 0 0   1 1 0 0 0  0 0 1 2
2 1 0 0 0 0   0 0 1 0 0   1 1 0 0 0   0 1 0 3 0  0 0 1 2
2 1 0 3 3 0   0 0 1 0 0   1 1 0 0 0   0 0 0 0 0  0 1 1 2

2 1 0 3 3 0   0 0 0 0 0   1 1 0 0 0   0 1 0 0 0  0 1 1 2
2 1 1 1 1 1   1 1 1 1 1   1 1 1 0 1   1 1 0 0 0  0 0 1 2
2 2 2 2 2 2   2 2 2 2 2   2 0 0 0 0   0 1 0 3 3  0 0 1 2
2 2 2 2 2 2   2 2 2 2 2   2 2 0 0 0   0 1 1 1 1  1 1 1 2
2 2 2 2 2 2   2 2 2 2 2   2 2 2 2 2   2 2 2 2 2  2 2 2 2