0 0 0 0 0 0   0 0 0 0 0   0 0 0 0 0   0 0 0 0 0  0 0 0 0
0 9 9 9 9 9   9 9 9 9 9   9 0 0 0 1   1 0 0 0 0  0 0 0 0
0 9 1 1 1 1   9 2 1 1 2   9 9 9 9 9   9 9 9 9 9  9 9 9 0
0 9 1 1 2 2   9 2 1 1 2   9 1 1 9 1   1 9 1 1 1  1 1 9 0
0 9 1 1 1 1   9 1 1 1 1   9 1 1 9 1   1 1 1 2 2  2 1 9 0
0 9 9 9 9 1   9 1 9 9 9   9 9 1 9 1   1 1 1 2 2  2 1 9 0

0 9 1 1 1 1   1 1 1 1 1   1 1 1 1 1   1 9 1 1 1  1 1 9 0
0 9 1 1 1 1   1 1 1 1 1   1 1 1 1 1   1 9 9 1 1  9 9 9 0
0 9 9 9 1 9   9 9 9 9 9   9 9 9 1 1   9 9 1 1 1  1 1 9 0
0 9 1 1 1 1   1 1 9 1 1   9 9 1 1 1   1 9 1 2 1  1 1 9 0
0 9 1 2 2 1   1 1 9 1 1   9 9 1 1 1   1 1 1 1 1  1 9 9 0

0 9 1 2 2 1   1 1 1 1 1   9 9 1 1 1   1 9 1 1 1  1 9 9 0
0 9 9 9 9 9   9 9 9 9 9   9 9 9 1 9   9 9 1 1 1  1 1 9 0
0 0 0 0 0 0   0 0 0 0 0   0 1 1 1 1   1 9 1 2 2  1 1 9 0
0 0 0 0 0 0   0 0 0 0 0   0 0 1 1 1   1 9 9 9 9  9 9 9 0
0 0 0 0 0 0   0 0 0 0 0   0 0 0 0 0   0 0 0 0 0  0 0 0 0